4 4
O . O . O | O
.   .   .   -
O | O . O . O
.   .   -   -
O | O . O . O
.   .   .   .
O | O | O . O

Problem-solving question 2
